WWWWWWTTTTWWWWWW
WFFFFFFFFFFFFFFW
WFFFFFFFFFFFFFFW
WFFFFFFFFFFFFFFW
WFFFFFFFFFFFFFFW
WFFFFFFFFFFFFFFW
LFFFFFFFFFFFFFFR
LFFFFFFEEFFFFFFR
LFFFFFFEEFFFFFFR
LFFFFFFFFFFFFFFR
WFFFFFFFFFFFFFFW
WFFFFFFFFFFFFFFW
WFFFFFFFFFFFFFFW
WFFFFFFFFFFFFFFW
WFFFFFFFFFFFFFFW
WWWWWWBBBBWWWWWW
