WWWTTWWW
W      W
W      W
L      R
L      R
W      W
W      W
WWWBBWWW
