WWWWWWTTTTWWWWWW
WFFFFFFFFFFFFFFW
WFFFFFFFFFFFFFFW
WFFFFFFFFFFFFFFW
WFFFFFFFFFFFFFFW
WFFFFFFFFFFFFFFW
LFFFFFFFFFFFFFFR
LFFFFFFSSFFFFFFR
LFFFFFFSSFFFFFFR
LFFFFFFFFFFFFFFR
WFFFFFFFFFFFFFFW
WFFFFFFFFFFFFFFW
WFFFFFFFFFFFFFFW
WFFFFFFFFFFFFFFW
WFFFFFFFFFFFFFFW
WWWWWWBBBBWWWWWW
